30 30
222222222222222222222222222222
300010000000000000000000000003
300010000000000000000000000003
300010000000000000000000000003
300010000000000000000000000003
300010000000000000000000000003
300010000000000003000000000003
300000000000000003000000000003
300000000000000003000000000003
300000000000000003000000000003
300000000000000003000000000003
300000000000000003000000000003
300000000000000002222222222223
300000000000000000000000000003
322222222200000000000000000003
300000000400000000000000000003
300000000400000000000000000003
300000000400000000000000000003
300000000400000000000000000003
300000000400000000000000000003
300000000400000000000000000003
300000000400000000000000000003
300000000400000000000000000003
300000000000000000000000000003
300000000000000000000000000003
300000000000000000000000000003
300000000000000000000000000003
300000000000000000000000000003
300000000000000000000000000003
333333333333333333333333333333